1111111111
10P000E101
1000111101
10C0000001
1111111111