111111111111111111111111111111111111111111111111111111111111111111111111
111111111111111111111111111111111111111111111111111111111111111111111111
111111111111111111111111111111111111111111111111111111111111111111111111
100010000001000001111111111111111111111111111111111111111111111111111111
10010000001C000001111111111111111111111111111111111111111111111111111111
100P10000001000001111111111111111111111111111111111111111111111111111111
1000010000000C0001111111111111111111111111111111111111111111111111111111
100C000000C0000001111111111111111111111111111111111111111111111111111111
100010000001000001111111111111111111111111111111111111111111111111111111
10010000001C000001111111111111111111111111111111111111111111111111111111
100010000001000001111111111111111111111111111111111111111111111111111111
1000010000000C0001111111111111111111111111111111111111111111111111111111
100C000000C0000001111111111111111111111111111111111111111111111111111111
100010000001000001111111111111111111111111111111111111111111111111111111
1001E000001C000001111111111111111111111111111111111111111111111111111111
100010000001000001111111111111111111111111111111111111111111111111111111
1000010000000C0001111111111111111111111111111111111111111111111111111111
100010000001000001111111111111111111111111111111111111111111111111111111
100C010000000C0001111111111111111111111111111111111111111111111111111111
111111111111111111111111111111111111111111111111111111111111111111111111
111111111111111111111111111111111111111111111111111111111111111111111111
111111111111111111111111111111111111111111111111111111111111111111111111
111111111111111111111111111111111111111111111111111111111111111111111111
111111111111111111111111111111111111111111111111111111111111111111111111