1111111111
111CE00111
1111110111
1000000P01
1111111111