1111111111
10E1000101
1100001101
10C1000001
1111111111