1111111111
10010E0101
1101001101
10010P0001
1111111111