1111111111
10P1000101
1100001101
10C1000001
1111111111