11111111111111111111
10001000000100000111
1001E000001C00000111
100P1000000100000111
1000010000000C000111
1000000000C000000111
11111111111111111111