111111111111111111
100010000001000001
1001E100001C000001
100P10000001000001
1000010000000C0001
100C000000C0000001
111111111111111111