111111111111111111
1000001P0001000001
10010101001C000001
100E10C01001000001
1000010100000C0001
100C001000C0000001
111111111111111111